        #######################
        #######################
        #######################
        #######################
####  #########################
####  #########################
###    ########################
###           #################
####         ##################
####         ##################
#####       ###################
######         ################
##            #################
##       ######################
###############################
###############################
###############################
###############################
###############################
###############################
###############################
###############################
###############################
###############################
###############################
###############################
###############################
###############################
###############################
###############################
###############################
###############################